稻时代	稻时代煲仔饭
速度与激情	速度与激情小龙虾
送瑞	送瑞私家菜
堡爷	堡爷炸鸡汉堡
天外桃源	天外桃源大酒店
好吃婆	好吃婆地道湘菜馆
乐中乐	乐中乐邻家小菜
少爷的虾	少爷们的虾
摩斯	摩斯汉堡
李小老	李小老烧饼
无敌少女	Miu无敌少女甜品店
速家	速家优品便利店
好米炊	好米炊套餐饭
个斑马	个斑马音乐烧烤吧
渔叔	渔叔无骨烤鱼饭
海清甜	海清甜创意甜品
滋啦啦	滋啦啦上海生煎
金牛角王	金牛角王中西餐厅
仇大师	仇大师匠酱骨
贺大娘	贺大娘快餐
七欣	七欣天品蟹轩三更外卖
陈生记	陈生记过桥米线
陈派	陈派肉串铺
骨器	骨器排骨饭
麦格芬	麦格芬西餐厅
田木町	田木町鲜果
粤新	粤新茶餐厅
老班头	老班头快餐
松妹	松妹快餐店
娇艳	娇艳酒吧
圆门	圆门干面馆
堕落龙虾	堕落小龙虾
大亨里	大亨里牛蛙面商务套餐
轻能量	轻能量沙拉简餐
活卤君	活卤君海鲜辣卤
恭候多食	恭候多食便当
宴华	宴华酒楼
TC	TC私家烘焙
敢秀	敢秀酸辣粉
北李妈妈	北李妈妈菜
卡漫莫尼	卡漫莫尼蛋糕
五斗橱	五斗橱四川滋味馆
蜗牛叔叔	蜗牛叔叔的食堂
食八掌	食八掌焖烧牛肉饭
麦山伴茶	麦山伴茶饮品店
鸿毛	鸿毛饺子
刚巧	刚巧烘焙工作室
小小鱼	小小鱼便当
素谷	SOGOOD素谷
聚堡客	聚堡客炸鸡汉堡
红巷子	红巷子胡大小龙虾
卜峰莲花	卜蜂莲花
八角杯	AbutlambCoffee八角杯咖啡
七毛八块	七毛八块快餐小碗菜
舒来喜	舒来喜鱼锅
尤广记	尤广记牛杂王
逸山	ESSENCOFFEE逸山咖啡
车前外带	车前外带寿司
河岸	河岸制果
食之缘	食之缘简餐
绝美嘉	绝美嘉海鲜馄饨
好鼎盛	好鼎盛酒店
巴姐	巴姐酸辣粉
马莲花	马莲花手拉面
王永生	王永生榨菜肉丝面
爸爸糖吐司	爸爸糖手工吐司
川海丰尚	川海丰尚砂锅麻辣烫
柳爷	柳爷私房菜
卤德堂	卤德堂美食
全家便利	全家便利店
可以喝的	觅姐汤可以喝的麻辣烫
西门里	西门里记忆中的味道
许爷	许爷剁椒鱼头
平衡	平衡粥店
察理	察理王子
隔壁小梁	隔壁小梁砂锅米线
韩阳馆	韩阳馆韩式料理
驴小猫	驴小猫特色拌面
小蛮	小蛮椒麻辣烫
琥珀老六	琥珀老六龙虾
焗里焗外	焗里焗外芝士焗饭
怡诺	怡诺水果捞
医保	医保城
容先生	容先生夫妻肺片
小哈皮	小哈皮龙虾香辣蟹跳水蛙
大肆	大肆撸串
笑江南	笑江南过桥米线
胖小鲜	胖小鲜砂锅麻辣烫
久胜	久胜蛋糕
辣么棒	辣么棒麻辣烫
通乐	通乐饭馆
浪记	浪记面店
醉南拳	醉南拳客家菜
阳澄金蟹阁	阳澄金蟹阁大闸蟹
哈比特	Habit哈比特汉堡
凤凰姑娘	凤凰姑娘鱼粉
李胖	李胖蜀香快餐
巴方	巴方酸辣粉
麦兹乐	麦兹乐汉堡奶茶
乐米欧	乐米欧法式西点
荷您有约	荷您有约荷叶饭
民泰	民泰冷面馆一部
阿龙煲	阿龙酒煲
姜创新	姜创新麻辣烫油炸店
大乐	大乐肉串店
哈德姆	哈德姆汉堡店
田波再回首	田波再回首泡椒牛蛙
与时代	芋时代
魔膳师	魔膳师美食工坊
全盈	全盈生鲜
南阳茶铺	南洋茶铺
半斗米	半斗米水果
小黑马	小黑马盖浇饭
川仙阁	川仙阁麻辣烫
品味非凡	品味非凡川菜
美琪萨	美琪萨芝士饭意面
血受	血受吃货铺专业套饭小吃
马扎子	马扎子烤肉
咬福	咬福包子
哈帝斯	哈帝斯汉堡
鱼满屋	鱼满屋酸菜鱼
林静	林静小吃
朱红	朱红麻辣烫
延庆	延庆观炸鸡
574	0574龙虾的故事
故乡情	故乡情北京烤鸭
茶语茶	茶语茶饮品店
清哥重庆麻辣烫	清哥重庆麻辣烫花甲粉
群意	群意馅饼
肉卷烧饼	又卷烧饼
琴岛顺天	琴岛顺天馄饨
大麦乐	大麦乐汉堡
悦瘦	悦瘦沙拉果汁
薄冰	薄冰羊肉粉
小西西	小西西热卤鸭货
阿姨很忙	阿姨很芒
黄太后	黄太后御膳研究所
熙香	熙香小厨
猫眼石	茶阁里的猫眼石
日月伴	日月伴面馆
众家灯火	众家灯火煎饼庄
可以喝	觅姐汤可以喝的麻辣烫
嘿卤	嘿卤卤汁饭
包猪公	包猪公卷饼
兰正韩	兰正韩韩式烤肉拌饭
无限	无限创作鸡肉饭
欢子	欢子盖浇饭
蛙舍	蛙舍炭烧牛蛙
衍生	衍生生活超市
永盈	永盈茶餐厅
男子汉	男子汉炒饭
京慧园	京慧园麻辣香锅
鼎有名	鼎有名生煎
鑫小城	鑫小城故事
包太郎	包太郎煲仔饭
磨豆时光	磨豆时光豆浆简餐
曼香记	曼香记泰式蛋包饭炒饭
胡二	胡二麻辣烫
乐哈哈	乐哈哈超市
黑科技	LABNSF黑科技茶饮实验室
高建民	高建民驴肉火烧
四英寸	四英寸现烤三明治
共禾	共禾之约创意轻食
朴道草堂	朴道草堂主食沙拉
悦来福	悦来福东山海鲜
觅豆	觅豆豆花甜品
辛派	辛派牛肉粉
里手	里手馄饨
宝轩鱼府	宝轩渔府
wode	wode沃德面包
北膳坊	北膳坊私房菜
叫了个炸	叫了个炸鸡
傻子张	傻子张大盘鸡
地理生鲜	地利生鲜
辣巴川	辣巴川冒菜
彤德莱	彤德莱火锅
当思	当思便当
美宜多	美宜多生活超市
绿叶子	绿叶子进口超市
24鲜	24鲜fresh
天天客	天天客快餐
杰西五	杰西五炸鸡汉堡
辣英	辣英鸡爪爪
茶狗	茶狗鲜奶茶
老大坊	老大坊生煎
小团子	小团子麻辣烫
寻欢	寻欢焖烤羊肉串
辣骨将	辣骨将辣骨饭
蜀里	蜀里成都名小吃
清口清汤	清口清汤面
穆桂英	穆桂英美食
和番丼饭	和番丼飯
学哥	学哥川味快餐
闹闹	闹闹的茶
三碗饭	三碗饭麻辣香锅
厝内小	厝内小眷村
熙小姐	熙小姐现煮奶茶
张少爷	张少爷私房甜品店
德鑫全	德鑫全排骨米饭
手作功夫茶	手作功夫茶KungFuTea
马叔	马叔的店
个个鲜	个个鲜水果超市
7	007牛肉面馆
道禾	道禾精致寿司
老仓醋	老仓醋米线
八斗鸡	八斗鸡私房菜
楼兰味央	新疆楼兰味央
苏云轩	苏云轩中式快餐
王阿盖	王阿盖手工小吃
美绎味	美绎味麻辣香锅
和平鸽	和平鸽水吧
夏拉拉	夏拉拉便当轻食
刺臂	刺臂健身餐
椒锅锅	椒锅锅麻辣香锅
木桑	木桑水产
charlie	Charlie
烤肴	烤肴烧烤
天天多多乐	天天多多乐蛋包饭
布谷布谷	布谷布谷热干面
杜奶奶	杜奶奶牛肉馅饼
优同	优同便利店
溜鱼	溜鱼小龙虾
质馆	质馆咖啡
天外	天外桃源大酒店
曰禾饭	曰禾饭概念便当
超姐	超姐年糕团
郎记	郎记天香麻辣烫
耍茶	耍茶JustRightTea
美味光顾	美味光顾鸡煲
壹头牛	壹头牛跷脚牛肉
尬吃	尬吃麻辣香锅
桃源眷村	桃园眷村
布莉安	布莉安石窑面包
茗战	茗战芝士茶
如意馄钝	如意馄饨
大田家	大田家韩国料理
一秒盛夏	一秒盛夏土豆冰粉
八勺抄手	8勺抄手
十二家	十二家沙拉
光头许	光头许包子铺
正传	正传鸡爪王
深运	深运潮州粥
乐颂	Leseul乐颂法式甜品
蔬jiang	蔬jiang轻食便当
唐纳滋	美仕唐纳滋
欢喜家	欢喜家奶茶
握在手心	握在手心海苔饭团
韩小屋	韩小屋烤肉饭
大京园	大京园海鲜烧烤
王萍	王萍面皮
百圣格	百圣格炸鸡汉堡
诚铭记	诚铭记老成都名小吃
康佰家	康佰家大药房
大男人	大男人煮义
老三院	老三院粉店
秦岳轩	秦岳轩陕西面馆
包煮婆	大龙燚包煮婆火锅菜
秦御仙	秦御仙五色凉皮盖浇饭
食三姨	食三姨麻辣烫
隔壁老白	隔壁老白瘦肉丸
狐喜	狐喜炸鸡汉堡潜艇热狗
七星果园	7星果园
俏麦园	俏麦园八宝粥
蒸泰	蒸泰包子铺
团妈	团妈便当企业外卖城西店
韩礼	韩礼年糕
阿芮	阿芮烤鸡爪
爱森	爱森优选
85c	85度C
苏蜜儿	苏蜜儿沙拉
林东家	林东家炸酱面
阜城德克士	德克士
麻辣老司机	麻辣老司机麻辣海鲜小龙虾
巴黎贝	巴黎贝甜
七欣天品蟹轩	七欣天品蟹轩三更外卖
一只酸	一只酸奶牛
二十五块	二十五块半
敲三记	敲三记生煎馒头
毛家地	毛家地大食堂
浙师傅	浙师傅麻辣香锅
鑫汇	鑫汇火锅
耶里	耶里夏丽
坛烧	坛烧八味
夏朵	夏朵十二篮
秦少爷	秦少爷肉夹馍
翟三岁	翟三岁糖水铺
小木船	小木船烤冷面
卢大师	庐大师
二必居	二必居美味店
味品会	味品会酒楼
大肥鱼	大肥鱼酸菜鱼米饭
金妈家	金妈家韩式烤肉
富雅	富雅菜馆
宝葫芦	宝葫芦西北传统名小吃
牛了个粉	牛了个粉常德牛肉粉
骨啦啦	骨啦啦辣骨饭
共禾之约	共禾之约创意轻食
好便宜	好便宜快餐
奇匣	奇匣神秘小炒
豫川	豫川通汇麻辣香锅
甜水井	甜水井馄饨
墨菲	墨菲烘焙
初饭	CF初饭coffeebrunch
客来福	客来福大食堂
严厨	严厨老坛酸菜鱼
潼乐	潼乐肉夹馍
芋颜季	芋颜季TaroStudio
荷香奇食	荷香奇食荷叶饭
拌将	拌将干拌麻辣烫
无敌家	无敌家拉面
半夜虾叫	半夜虾叫小龙虾
沙哇	沙哇低卡轻食沙拉
酷范	酷范炸鸡啤酒
假装很酷	假装很酷的米粒
牛精华	牛精华牛排饭
订一客	订一客日式料理
饭桶家	饭桶家台湾鸡排饭
杉木	杉木日本料理
添福来	添福来饺子城
黄大妈	黄大妈木桶饭
喜九	喜九包子铺
卤掌门	卤掌门卤肉饭
另茶	OT另茶
每日英雄	每日英雄轻食
潮泰	潮泰牛肉店
老妈烫	老妈烫饭
杰记	杰记水果
喜豚	喜豚亚洲猪排专门店
耶里夏	耶里夏丽
李部长	李部长炸鸡啤酒
桂小二	桂小二卤味香锅
集集	集集小镇
魏嘛	魏嘛龙虾烧烤精酿
寻魅	寻魅辣骨饭
星能量	星能量STARENERGY健康餐
小倩倩	小倩倩馄饨
和先生	和先生的砂锅鱼
宏明	宏明西饼
开心麦田	开心麦田炸鸡汉堡
金牡丹	金牡丹大酒楼
七叶和茶	七叶和茶日式料理
金良	金良酸菜鱼
七只虾	七只虾辣卤海鲜
乐游记	乐游记家常菜
辛麦田	辛麦田麻辣烫
荣基	荣基快餐
至味优良	至味优粮
哈吉克	哈吉客
劲莲	劲莲万州炸酱面
十点整	十点整小龙虾
五德居	五德居白斩鸡
德乐堡	德乐堡汉堡披萨
dunkin	Dunkin
知百味	知百味家常菜
紫光	紫光园
大铁牛	大铁牛螺蛳粉
蔬肉大王	蔬肉大王煎鸡饭卤肉饭
俏奶奶	俏奶奶鸡汤饭
叶派	叶派龙虾
张亮麻辣	张亮麻辣烫
彭浦第一	彭浦第一炸
一茶一座	一茶一坐
宋太子	宋太子锅贴鸡粥铺
南京大	南京大牌档
段式龙虾	段氏龙虾
把愚	把愚便当
沃歌斯	Wagas沃歌斯
董立兵	董立兵烤鸭
二斗	天津二斗栗子
竹叶饭	陆兴竹叶饭
汤城	汤城小厨
汪世兴	汪世兴京味烤鸭
由氏	由氏麻辣香锅
盆派	盆派冒菜
猴大棒	猴大棒肉汁排骨饭
满宝馄炖	满宝馄饨
彦悦山	彦悦山草本养生饮品
烧火铺	烧火铺火锅
晓亮	晓亮麻辣拌
湘当馋	湘当馋臭豆腐
诚实	诚实果品
骨之风	骨之风辣骨饭
卤辣辣	卤辣辣鸭头
无限创作	无限创作鸡肉饭
美速	美速餐饮
馍饭传奇	馍饭传奇凉皮肉夹馍
安少爷	安少爷米线
花小野	花小野手作甜品
慕实好	慕实好爆肚
吴小糖	吴小糖沙拉煎饼
密斯金	密斯金韩餐
鱼旨	鱼旨寿司
酷乐普斯	酷乐普斯蛋包饭
青沫	青沫茶颜
喂饱你	喂饱你品质双拼餐
遇花溪	遇花溪苗家牛肉粉
香他	香他她煲仔饭
潘小烧	潘小烧云南夜宵烧烤
陈陈家	陈陈家煎饼果子酸辣粉爆肚
苏小煮	苏小煮蘸菜
古田稻香	谷田稻香
李庄	李庄白肉
老人和	老人和饭店
汀洲佬	汀洲佬客家鸭肉粥
杨国福麻辣	杨国福麻辣烫
狂热	狂热外带寿司
酱样儿	酱样儿三文鱼石锅拌饭
佰人王	佰人王串串香
李海龙	李海龙麻辣烫
王阿姨	夜市王阿姨豆浆油条店
飞凤	飞凤小吃
孙平	孙平大包
福大师	福大师烧鹅王
果腿儿	果腿儿鲜果切
伊鼎湘	伊鼎湘常德牛肉粉
够厚么	够厚么老无锡浇汁饭
品凡	品凡水果捞
卤馆	卤馆热卤拌饭
罗义德	罗义德私房小吃
奈哥	奈哥老坛酸菜鱼
肚里有料	肚子里有料
小江水	小江水点心店
东方既白	东方既白肯德基的兄弟品牌
蝎王府	蝎王府羊蝎子
胖天使	胖天使量贩健身餐
果果卤	果果卤小海鲜
甬正	甬正麻辣香锅
乐萃	乐萃咖啡
小汤主	小汤主东南亚风味麻辣烫
蟹老宋	蟹老宋香锅
瞒着爹	瞒着爹海派中式名点
小黄家	小黄家香辣鸡爪
818	818中餐厅
胖胖粉	胖胖粉砂锅
多多和	多多和馅饼
和家乐	和家乐私房菜
刘妞妞	刘妞妞厨义工坊
壹刻	1CAKE壹刻蛋糕
可莎	可莎蜜兒
美乐园	美乐园快餐
裕昌	裕昌食品
梳芙	SOFU梳芙
阿依来	阿依来新疆餐厅
吴弟	吴弟粉浆面条
狼叔叔	狼叔叔杏仁腐
乐一	乐一早餐
微啃	微啃鸡排
叉子汤勺	叉子汤勺健康沙拉轻食
匡记	匡记饺子
东发道	东发道粉面餐室
美颐美	美颐美鲍汁排骨饭
麻省理工	麻省理功
派大星	派大星厨房
舒婷	舒婷果业
鼎速	鼎速创意寿司
秋云萍	秋云萍快餐
刘帅	刘帅麻辣烫
留夫	留夫鸭
丽驰	丽驰烘焙
月牙湾	月牙弯手工水饺
辣呦	辣呦中国菜
静安小亭	静安小亭麻辣烫
花季语	花季语寿司
同仁四季	同仁四季煲仔饭
太谷	太谷食堂
方大同	方大同胡辣汤
俏师妹	俏师妹麻辣烫麻辣拌
三上	三上料理
teasoon	teasoon茶首
蔬小盒	SHUBO蔬小盒
时草	时草烤肉沙拉饭
甜嫩嫩	iFood甜嫩嫩
顺天	琴岛顺天馄饨
九中老白	九中老白串串香
茉莉花	茉莉花餐厅
吴山烤禽	杭州吴山烤禽
阿姨阿叔	阿叔阿姨的店
特特	特特水果
鼎灿	鼎灿瘦肉丸
辣皇朝	辣皇朝小龙虾
云荷香居	云荷香居荷叶饭
CoCo都	CoCo都可
桂洲村	桂洲村桃酥
小管家	小管家家常菜馆
mimiyoyo	mimiyoyo韩国炸鸡
七十一号	七十一号豆汤饭
花快到	花快到鲜花
卤来享	卤来享熟食
萨路德	萨路德披萨
草没味	草没味儿
元兆	元兆寿司
汉忠	汉忠炊饭
愉肴	愉肴麻辣香锅
梁老三	梁老三麻辣鸡头
那记	那记猪手
煲百味	煲百味煲仔饭
三泉	三泉冷面
味行动	味行动麻辣香锅
813	813芭依珊BAESAN
好小胖	好小胖私厨
乌巢	乌巢比萨主义主题餐厅
巴厘	巴厘龙虾
丸来丸趣	丸来玩趣
志胜	志胜炸鸡汉堡
李十八	李十八凉皮肉夹馍
万龙洲	万龙洲海鲜
玛格萝妮	玛格萝妮餐厅
停不了	停不了小龙虾大闸蟹
凡塔斯	凡塔斯牛排
觅姐汤	觅姐汤可以喝的麻辣烫
四有	四有青年米粉面
草包	草包包子铺
得一鲜	得一鲜面馆
冰之优作	冰之优作雪域慕斯蛋糕
西粉堂	西粉堂新疆米粉
沃德	wode沃德面包
席永记	席永记汤包馆
老头爱马仕	老头爱马仕酸豇豆炒饭
x造杯	X造杯
梦甜	梦甜蛋糕店
乡村鸡	乡村基
叁拾加	叁拾加水果专家
千座	千座港式牛杂
前王	前王排骨
阿曹	阿曹热炒
台食记	台食记美食便当
王良才	王良才酸菜鱼
知乎	知乎茶也
乐速	乐速面疙瘩
动力机车	动力鸡车
YASO	YASO沙拉
豫川通汇	豫川通汇麻辣香锅
舍外	舍外胡辣汤
家传	家传麻辣香锅
马有才	马有才牛肉面的故事
玛尚诺	PizzaMarzano玛尚诺
疆料	疆料新疆炒米粉
碎绿	ChoppedGreen碎绿沙拉
嘿米	嘿米饭堂
香传八里	香传八里小炒套餐
不二锅	不二锅FUJIPOT小火锅
黄小拌	黄小拌麻辣拌
江同学	江同学烤蹄
人在	人在茶在
会有	会有便利
圣道	圣道烤肉
好色派	好色派沙拉
左庭右院	左庭右院鲜牛肉火锅
龙巢	龙巢盱眙龙虾
秀兰	秀兰鸭血粉丝
耕喜	耕喜台湾水果茶
荣华基	荣华基大食堂
温永商	温永商购物中心
橘味	橘味餐厅
汉泰	汉泰中泰融合餐厅
龙人居	龙人居水煮三峡鱼
285	285蚝味馆
焖范儿	焖范儿三汁焖饭
口口碑	口口碑汉堡
喜唐	喜唐精致水饺
吉先生	吉先生韩式炸鸡
贝嫂	贝嫂创意汤底麻辣烫
福兰德	福兰德酒楼
一口元气	一口元气YiKoKi寿司
兄弟情	兄弟情海鲜烧烤
广隆	广隆蛋挞王
食不可待	食不可待脆皮炸鸡饭
comebuy甘杯	COMEBUY甘杯
红小姐	红小姐可以拌着吃的麻辣烫
仙中草	仙中草茶饮
飞花令	飞花令好吃不上火的麻辣烫
德川家	德川家日本料理
好好小姐	好好小姐扒饭主题餐厅
红杏	红杏酒家
生辉	生辉烧卤
身材	身材食料轻食沙拉
外婆记	外婆记菜饭骨头汤
黑眼熊	黑眼熊寿司日式便当
uneed	Uneed轻食
70后	70后饭吧
木与同	木与同三明治
蛋宝宝	蛋宝宝煎饼果子
管氏	管氏翅吧
喜连连	喜连连永和豆浆
品利源	品利源凉皮
高乐雅	高乐雅咖啡
潇洒姐	潇洒姐凉皮
白下元宵	白下元宵铺
小君作	小君作铁板烧简餐
三花奶奶	三花奶奶的甜品
他舅家	他舅家肉夹馍
汤同学	汤同学麻辣烫
兴达	兴达美食
礼颂	礼颂至品
周正	周正水煮活鱼
旺池	旺池川菜
广九	广九餐室
大佬王	大佬王牛肉面
上隐	上隐荷叶饭
李不管	李不管把把烧
骨辘辘	骨辘辘辣骨饭
门三公	门三公大盘鸡拌宽面
食朝汇	南京食朝汇
辣佰轩	辣佰轩麻辣烫
田归农	田归农快送水果
泰煌	泰煌鸡
町上	町上寿司
4219	4219主食沙拉
桂源	桂源铺
火齐	火齐潮汕砂锅粥
山间堂	山间堂民间瓦罐煨汤馆
武圣	武圣羊杂割
漱玉平民	漱玉平民大药房
会飞的鸡	会飞的鸡Flyingchicken
蒙恩	蒙恩蛋糕店
七小姐	七小姐的58道菜
天泰	simplythai天泰餐厅
二奎	二奎碗饭
煜北	煜北西北小馆
云味馆	云味馆过桥米线
里食真	里食真馄饨
鱼你说	鱼你说酸菜鱼米饭
飞鸿	飞鸿肉夹馍
鑫龙福	鑫龙福麻辣烫
颂饭	颂饭精致水饺
强能	强能鱼圆
松桂坊	松桂坊腊味煲仔饭
930	930私房菜
叹得意	叹得意茶餐室
醇百味	淳百味
水脉堂	水脉堂海鲜粥
超级机车	超级鸡车
阿利	阿利茄汁面
冠记	冠记肠粉专家
新隆	新隆嘉超市
清口清	清口清汤面
侠饭	侠饭寿司丼饭
义泰昌	义泰昌现炒快餐
海中洲	海中洲国际大酒店
丽华园	丽华园酒店
苏洪	苏洪鲜食
川町	川町太郎
神龟	神龟馅饼
糖爸爸	爸爸糖手工吐司
李喜旺	李喜旺牛腩饭
令君	令君麻辣香锅
comebuy	COMEBUY甘杯
饭十七	饭十七便当
我爱我汤	我爱我汤麻辣烫
未来餐厅	未来餐厅概念店
御状元	御状元慢熬粥
微醺	微醺茶饮WeDrink
随你点	随你点便当
金碧辉煌	金碧辉煌串吧
深水茶	Deeptea深水茶
颜家	颜家辣酱鸭
美肴	美肴冰品
虾与稻	虾与稻快餐
如意馄炖	如意馄饨
井盒	井盒炒饭
九头鹰	九头鹰酒家
意淇	意淇港式下午茶
秒生活	妙生活水果生鲜便利店
素匠泰	素匠泰茶
齐状元	齐状元粥饼品质外卖
汆悦	汆悦麻辣烫
来购	来购超市
杨麻子	杨麻子大饼
集正	集正超市
片片福	片片福肉片工匠
船歌鱼	船歌鱼水饺
美闻	美闻比萨
长发	长发西饼
串意	串意十足烧烤店
高祖	咬不得高祖生煎
盛宝	盛宝粥店
锡笼记	锡笼记小笼馄饨
南城	南城香
庙东	庙东排骨
巧盒	巧盒甜品茶饮蛋糕伴手礼
梦花街	梦花街馄饨
海盗虾饭	海盗虾饭龙虾饭
船歌	船歌鱼水饺
杨翔	杨翔豆皮涮牛肚
最得意	醉得意
宝盛元	宝盛元饺子
张妈妈	张妈妈特色川味馆
六十八	六十八号披萨
澳牛	澳牛鲜奶吧
海王星辰	海王星辰健康药房
丑学长	丑学长酸菜鱼
泰匠泰茶	素匠泰茶
郑文琪	郑文琪龙虾盖浇饭
骨干精英	骨干精英排骨饭
sevenbus	SEVENBUS
权味	权味石锅拌饭
果之满满	果之满满鲜榨果汁
半边天	半边天熏肉大饼
风和日丽	丰和日丽
六十八号	六十八号披萨
呷煮呷烫	呷哺呷煮呷烫
牛不理	牛不理八宝粥
子母	子母粉丝
神威	神威大药房
饭小范	饭小范便当
阿泰	阿泰包子
老婆很芒	老婆很芒榴莲千层蛋糕
饭留香	饭留香炒饭
稻童	稻童小鲜粥
富龙	富龙快餐
张奶奶	张奶奶鱼丸
站点	站点比萨
四美	四美包子
馋师傅	馋师傅烧汁饭
牛牛站	牛牛站酸辣粉
九分	九分茶到
鸡鸣	鸡鸣汤包
德丽丝	德丽丝汉堡炸鸡
身材食料	身材食料轻食沙拉
香满城	香满城炸肉
乐大嘴	乐大嘴零食公园
权金城	权金城烤串拌饭
酷公社	酷公社榴莲披萨冒菜
金小悦	金小悦饭堂
塔哈尔	塔哈尔新疆盛宴
谷婆婆	谷婆婆八宝粥
泰奇	TouchBread泰奇面包
养生源	养生源粥店
溪雨观	溪雨观酸菜鱼
欢牛	欢牛蛋糕屋
星期一	星期一便当
bigbang	bigbang韩国炸鸡
范小喵	范小喵芝士焗饭
童婆婆	童婆婆酥肉
伊秀	伊秀寿司
猪宝盒	猪宝盒精致台式便当
港丽	港丽餐厅
小恒	小恒水饺
川成元	川成元麻辣香锅
紫燕百味	紫燕百味鸡
小放牛	小放牛河北菜
拼豆	拼豆夜宵
兜约	兜约下饭菜
小辉哥	小辉哥火锅
日昌	日昌餐馆
篱笆	篱笆小镇酸菜鱼
Wagas	Wagas沃歌斯
吉祥馄炖	吉祥馄饨
十八家	十八家面馆
肚子里	肚子里有料
道明	道明小吃
味为先	味为先豆腐脑
原味觉醒	原味觉醒健康餐
回味王	回味王麻辣烫麻辣香锅
旺顺阁	旺顺阁鱼头泡饼
锅sir	锅sir时尚火锅外卖
仔皇煲	仔皇煲煲仔饭
森山	森山仙草
汴京	汴京炸鸡
江南小镇	江南小镇无锡小笼包
三叔	三叔粥铺
胡爸爸	胡爸爸鸡骨
糊涂	糊涂生煎
十秒到	十秒到过桥米线
好牛	好牛烧肉
马里奥	马里奥饼店
广物	广物超市
隋炀帝	隋炀帝炒饭
睿健卡路里	睿健卡路里健康餐
三可	三可手工虾仁水饺
林妈妈	林妈妈刺身寿司
马金龙	马金龙麻辣烫
车前	车前外带寿司
好一家	好一家牛肉粉
饭小妹	饭小妹拌饭便当
天天中	天天中餐厅
9918	9918珍珠奶茶
喜勺	喜勺龙虾盖饭
赖胖子	赖胖子肉蟹煲
段氏	段氏龙虾
麻辣速递	麻辣速递酸辣苕粉
牛哥	牛哥的凉皮铺
小条	小条食堂
老百姓	老百姓大药房
老北桥	老北桥过桥米线
汉克斯	汉克斯炸鸡汉堡
城市名人	城市名人壹超市
口留香	口留香煎饼果子
烹火	烹火披萨
小谷姐姐	小谷姐姐麻辣拌
蜀地源	蜀地源冒菜
百香林	百香林西点
晨曦炖品	晨曦炖品鲍鱼饭
小六	小六汤包
四有青年	四有青年米粉面
景仁	景仁馅饼
老胜香	老胜香包子铺
蜀都丰	蜀都丰手工水煮活鱼
松哥	松哥油焖大虾小龙虾
小蛮椒	小蛮椒麻辣烫
舞爪	舞爪花椒鸡爪
虾小士	虾小士小龙虾轻食
千色色	千色色沙拉
秀海福	秀海福麻辣烫
热辣生活	热辣生活麻辣诱惑小龙虾
果汁满满	果之满满鲜榨果汁
三个先森	三个先森的韩国炸鸡
堕落	堕落小龙虾
潘大师	潘大师炸鸡腿
野有饭	野有饭野菜炒饭
春哥	春哥铁板烧
老狼	老狼大盘鸡
美玲	美玲拉面
哆哆客	哆哆客汉堡
千日贺	千日贺茶餐厅
池奶奶	池奶奶麻辣串
篱笆小镇	篱笆小镇酸菜鱼
孟夫子	孟夫子尚品煎包
汉库	汉库麻辣香锅
盛香亭	盛香亭新式热卤
正豪大大	正豪大大鸡排
隐烫	隐烫麻辣烫
贝克	贝克汉堡
真真	真真厦港卤味
陈华勇	陈华勇麻辣烫
猛男	猛男的炒饭
新纳西	新纳西炸鸡汉堡
火炉火	火炉火韩式拌饭
楼兰	楼兰新疆主题餐厅
串意十足	串意十足烧烤店
胥先生	胥先生鸭血粉丝汤
杨妈妈	杨妈妈粥品专家
比格	比格比萨
一纸鸡	一纸鸡锡纸烧肉饭
老头儿	老头儿油爆虾
大宝	大宝麻辣烫
辣有道	辣有道麻辣香锅
河风	河风精致寿司
川魂	川魂帽牌货冒菜
快乐星	快乐星汉堡
郑阿姨	郑阿姨特色馄饨
八点醒	八点醒黑糖甜品专门店
八婆婆	八婆婆烧仙草
粤仔湾	粤仔湾砂锅粥
艾可奇	艾可奇汉堡
能量巴士	能量巴士轻食健康餐
嘎嘎	嘎嘎鸭脑壳
老村长	老村长私募菜
延庆观	延庆观炸鸡
林妹妹	林妹妹沾水米线
多禾	多禾馅饼
永丰	永丰超市
朴小姐	朴小姐美食外卖
霸蛮	霸蛮牛肉粉
见福	见福便利店
七家湾	七家湾牛肉锅贴
虾点	虾点外卖
真圆	真圆粢饭团
大脸	大脸鸡排
乐活事	乐活事鲜果茶
李连贵	李连贵熏肉大饼
二姐	二姐粥铺
世界	世界茶饮
大咀	大咀港式茶餐厅
星巴克代购	星巴克咖啡代购
大维	大维饮品
手心的你	手心的你海苔饭团
米食先生	米食先生煲仔饭
周大虾盖浇饭	周大虾龙虾盖浇饭
亲爱的	亲爱的麻辣烫
比哥	比哥鸡排
绿叶	绿叶水果
憨老头	憨老头凉皮
白下	白下元宵铺
魔法帽	魔法帽牛肉和酱料火锅
三顾	三顾冒菜
过路人	过路人台湾饭团
老家	老家肉饼
五条人	五条人糖水铺
7017	7017味道工厂
鲜疯	鲜疯水果实验室
差一碗	差一碗鸡汤饭
一人一锅	一人一锅锅贴王
徐小包	徐小包的奶茶
张正	张正麻辣串
汤火功夫	汤火功夫麻辣烫
秦门	秦门馍饭厨房
小淮娘	小淮娘鸭血粉丝锅贴
文和友	文和友老长沙龙虾馆
马玉涛	马玉涛麻辣烫
中街	中街1946
柏记	柏记水饺
甘其食	甘其食粥包
KOI	Koi
甜蜜蜜	甜蜜蜜港式茶餐厅
丽华	丽华快餐
觅姐麻辣烫	觅姐汤可以喝的麻辣烫
拿渡	拿渡麻辣香锅
张太和	张太和本帮菜馆
新作	新作茶SunTea
乐多多	乐多多炸鸡汉堡
明康汇	明康汇生鲜
南大门	南大门米糕
不二心	不二心包子铺
新元素	新元素餐厅
姚老太	姚老太烧饼
汤先生	汤先生汤馆
红荔村	红荔村肠粉
糖纸	糖纸甜品
港堡	港堡汉堡炸鸡
王菊	王菊面馆
大通	大通冰室
加减	加减茶饮
哈灵	哈灵面馆
广芳园	广芳园老香港茶点
邻家	邻家便利店
大鼓	大鼓米线
巨饿	巨饿便当
王小姐	王小姐的茶
庐员外	庐员外豆浆油条
宝岛	宝岛便当
争鲜	争鲜回转寿司
老盛兴	老盛兴汤包馆
翠华	翠华餐厅
大娘	大娘水饺
大掌柜	大掌柜凉皮肉夹馍
好日子	好日子生鲜超市
吉妈妈	吉妈妈手擀面
凡仔	凡仔汉堡
苏客	苏客中式快餐
一芳水果茶	一芳台湾水果茶
继光	1973继光香香鸡
陕十三	陕十三肉夹馍
张秀梅	张秀梅烤肉拌饭
龙门	龙门花甲
沙拉拉	沙拉拉轻食
沙绿	沙绿沙拉波奇饭
叫了只	叫了只炸鸡
辣骨气	辣骨气辣骨饭
汉霸	汉霸汉堡
波客派	波客派炸鸡汉堡
芙蓉树下	芙蓉树下冒菜
新旺	新旺茶餐厅
刘胖子	刘胖子家常菜
青蔬	青蔬捞烫
潘老板	潘老板炸鸡
云海肴	云海肴云南菜
太平洋	太平洋咖啡
水天堂	水天堂西餐厅
黄记煌	黄记煌三汁焖锅
邻几	邻几便利店
牛吃草	牛吃草牛肉面
麦的多	麦的多烘焙
许留山	许留山港式甜品
麦多	麦多馅饼
沈老头	沈老头包子
姐弟俩	姐弟俩土豆粉
蜜哆哆	蜜哆哆韩式炸鸡
妯娌	妯娌老鸭粉丝汤
焦耳	焦耳川式快餐
康师傅	康师傅私房牛肉面
秘觉	秘觉外卖
叮咚	叮咚买菜
咬不得	咬不得高祖生煎
巴比	巴比馒头
魏家	魏家凉皮
新石器	新石器拌饭
好多肉	好多肉汉堡
茉莉香	茉莉香鸭颈王
廖记	廖记棒棒鸡
新华都	新华都购物广场
正一味	正一味石锅拌饭
阿香	阿香米线
有家	有家便利店
香他她	香他她煲仔饭
肥叔	肥叔锅贴
周大虾	周大虾龙虾盖浇饭
地利	地利生鲜
谷连天	谷连天八宝粥
妙生活	妙生活水果生鲜便利店
福荣祥	福荣祥烧腊
派乐	派乐汉堡
五谷	五谷渔粉
我呀	我呀便当
梁小猴	梁小猴铁板炒饭
阿拉丁	阿拉丁麻辣烫
辣府	辣府冒菜
尊宝披萨	尊宝比萨
山林	山林熟食
张阿姨	张阿姨奶茶
小马哥	小马哥卤肉饭
西少爷	西少爷肉夹馍
回味	回味鸭血粉丝汤
红唇	红唇串串香
乐凯撒	乐凯撒比萨
方中山	方中山胡辣汤
澜记	澜记老香港茶点
大鸭梨	大鸭梨烤鸭
味千	味千拉面
庆丰	庆丰包子铺
如意	如意馄饨
满宝	满宝馄饨
无名缘	无名缘米粉
一米香	一米香牛肉饭
元祖	Ganso元祖蛋糕
叫了个	叫了个炸鸡
尊宝	尊宝比萨
桥头	桥头排骨
金百万	金百万烤鸭
久久丫	久久丫鸭脖
杨铭宇	杨铭宇黄焖鸡米饭
吉祥	吉祥馄饨
新隆嘉	新隆嘉超市
东池	东池便当
曼玲	曼玲粥店
满记	满记甜品
悸动	悸动烧仙草
棒约翰	棒约翰比萨
老盛昌	老盛昌汤包
鲜丰	鲜丰水果
胖哥俩	胖哥俩肉蟹煲
达美乐	达美乐比萨
觅姐	觅姐汤可以喝的麻辣烫
曹氏	曹氏鸭脖
全时	全时便利店
紫燕	紫燕百味鸡
田老师	田老师红烧肉
西贝	西贝莜面村
张亮	张亮麻辣烫
一芳	一芳台湾水果茶
海底捞	海底捞火锅外送
正新	正新鸡排
杨国福	杨国福麻辣烫
绝味	绝味鸭脖
全家	全家便利店
叫了个鸡	叫了个炸鸡
星巴克	星巴克咖啡代购
